1111111111111
10E0000000001
10000000P0001
1000C00000001
100C000000001
1000000000001
1000000000001
1111111111111