111111111111111111111111111111111111111
100000000000100000000000000000011100001
100000000000000000000111111111000000001
1000C0001000000011110000000000000000001
100C00000000000011110000000000000000001
100000000000000011110000000000000000001
100000000000000011110111000000000000001
10000000000000000000110E100000000000001
100000000000100000010001000000011100011
1000000000000000000001111111110010011P1
1000C0001000000011110000000000001001001
100C00000000000011110000000000001001001
100000000000000011110000000000000000001
111111111111111111111111111111111111111
