11111111111111111
1000000E000010001
10P01000000011C01
100C0000000000001
10000001000000001
10000001000000001
10000001000000001
11111111111111111