11111111111111111
100000000000000C1
10P10010110011101
10110010010010101
10000010010010101
10110111011110101
101001000000001E1
11111111111111111