111111111111111111111111111111111111111
1C0000000000100000000000000000011100001
100000000000000000000111111111000000001
1000C0001000000011110000000000000000001
100C0000000C0000111C0000000000000000001
100000000000000011110000000000000000001
100010000000000011110111000001000000001
1001C100000000000000111E100000000000001
100000000000100000010000000000011100011
100000000P00000000000111101111001001101
1000C00010C0000011110000000000001001001
100C00000000000011110000000000001001001
100000000000000011110000000000000000011
111111111111111111111111111111111111111